30 14
WWWWWWWWWWWWWWWWWWWWWWWWWWWWWW
000000000000000000000000000000
000000000000000000000000000000
00000000000000WWW0000000000000
0000000EWWW0000000000000000000
000000000000000000000000000000
000000000000000WW0000000000000
000000000000000000000000000000
000000000000000000000000000000
00000000000W000000000000000000
00000000000000000000C000000000
WWW00000000W000000WWC000000000
000000000000000000WWS000000000
WWWWWWWWWWWWWWWWWWWWWWWWWWWWWW