14 10
WWWWWWWWWWWWWW
WEWWW00000000W
W0WW000000000W
W0W00WW000000W
W0000WW000000W
W00000W0000WWW
W00000W0W000WW
W00000W0W00WWW
W0WW00W00000SW
WWWWWWWWWWWWWW